5 6
4 4 4 4 4 4
4 0 0 0 0 4
4 0 0 2 1 4
4 0 1 2 0 4
4 4 4 4 4 4
1 1