7 7
5 4 4 4 4 4 5
4 4 1 0 0 4 4
4 0 0 4 0 0 4
4 0 2 3 2 0 4
4 0 0 1 0 0 4
4 4 0 1 0 4 4
5 4 4 4 4 4 5
2 3