6 7
4 4 4 4 4 4 5
4 0 0 0 0 4 4 
4 0 2 2 0 0 4
4 0 4 1 0 1 4
4 0 0 0 0 0 4
4 4 4 4 4 4 4
1 1