7 7
5 5 4 4 4 4 5
4 4 4 0 0 4 5
4 0 0 1 2 4 4
4 0 0 0 2 0 4
4 0 4 1 0 0 4
4 0 0 0 0 0 4
4 4 4 4 4 4 4
2 1