6 8
4 4 4 4 4 4 5 5
4 0 0 0 0 4 4 4
4 0 0 0 1 1 0 4
4 0 2 2 2 0 0 4
4 0 0 1 0 1 0 4
4 4 4 4 4 4 4 4
4 6